




			####################
			#        #         #
			#    A   #####Ï#####
			Ï        Ï         #
			#        #         #
			#        #         #
			##############Ï#####
			#    #         #   #
			#    Ï         Ï   #
			#    #         #   #
			#################Ï##
			               #   #
			               #   #
			               #   #
			               #   #
			               #   #
			               #   #
			               #   #
			               #   #
			               #   #
			               #   #
			               #   #
			               #   #
			               ##Ï##############
						   #               #
						   #               #
						   #               #
						   #               #
						   #               #
						   #               #
						   #               #
						   #               #
						   #################